^^^^^^^^^^^^^^^^^.............................................^^^^^^^^^^^^^^^^^^^^^^^^^^^^^^^^^^^^^^^^^^^^^^^^^^^^^^^^^^^^^^^^^^^^^^^^^^^^^^^^^^^^^^^^^^^^
^^^^^^^^^^^^^^^.....................................................................................^^^^^^^^^^^^^^^^^^^^^^^^^^^^^^^^^^^^^^^^^^^^^^^^^^^^^^
^^^^^^^^^^^^^................................................................................................^^^^^^^^^^^^^^^^^^^^^^^^^^^^^^^^^^^^^^^^^^^^^
^^^^^^^^^^^....................................................................................................^^^^^^^^^^^^^^^^^^^^^^^^^^^^^^^^^^^^^^^^^^^
^^^^^^^^^...........................................................................................................^^^^^^^^^^^^^^^^^^^^^^^^^^^^^^^^^^^^^^
^^^^^^^^...............*........................................................................................................^^^^^^^^^^^^^^^^^^^^^^^^^^
^^^^^^...................................................................................................................................^^^^^^^^^^^^^^^^^
^^^^.........................................................................................................................................^^^^^^^^^^^^^
^............................................................................................................................................~^^^^^^^^^^^^
^^................................................................................^^.............................................................^^^^^^^^^
^^^^...........................................................................^^^^^^............................................................^^^^^^^^^
^^^..........................................................................^^^^^^^^^^^...........................................................^^^^^^^
^.........................................................................^^^^^^^^^^^^^^^^............................................................^^^^
.....................................................^^.............^^^^^^^^^^^^^^^^^^^^^^^............................................................^^^
..................................................^^^^^^........^^^^^^^^^^^^^^^^^^^^^^^^^^^^^...........................................................^^
................................................^^^^^^^^^....^^^^^^^^^^^^^^^^^^^^^^^^^^^^^^^^^^..........................................................^
.............................................^^^^^^^^^^^^^^^^^^^^^^^^^^^^^^^^^^^^^^^^^^^^^^^^^^^^^^......................................................^
.........................................^^^^^^^^^^^^^^^^^^^^^^^^^^^^^^^^^^^^^^^^^^^^^^^^^^^^^^^^^^^^.....................................................
.............................^^^^^^^^^^^^^^^^^^^^^^^^^^^^^^^^^^^^^^^^^^^^^^^^^^^^^^^^^^^^^^^^^^^^^^^^^^^^.................................................
.............................~~~~~~~~~~~~~~~~~~~~~~~~~~~~~~~~~~~~~~~~~....................................................................................
..........................~~~~~~~~~~~~~~~~~~~~~~~~~~~~~~~~~~~~~~~.........................................................................................
.....................~~~~~~~~~~~~~~~~~~~~~~~~~~~~~~~~~~~~~~~~~............................................................................................
~~..............~~~~~~~~~~~~~~~~~~~~~~~~~~~~~~~~~~~~~~~~~.................................................................................................
~~~~..........~~~~~~~~~~~~~~~~~~~~~~~~~~~~~~~~~~~~~~~~~~~.................................................................................................
~~~~~~~.........~~~~~~~~~~~~~~~~~~~~~~~~~~~~~~~~~~~~~~~~~~~~..............................................................................................
~~~~~~~~~.....~~~~~~~~~~~~~~~~~~~~~~~~~~~~~~~~~~~~~~~~~~..................................................................................................
^~~~~~~~~~~~~~~~~~~~~~~~~~~~~~~~~~~~~~~~~~~~~~~~~~~~~.....................................................................................................
^^.~~~~~~~~~~~~~~~~~~~~~~~~~~~~~~~~~~~~~~~~~~~~~~~~~~~~~~.................................................................................................
^^^^~~~~~~~~~~~~~~~~~~~~~~~~~~~~~~~~~~~~~~~~~~~~~.........................................................................................................
^^^^^^^~~~~~~~~~~~~~~~~~~~~~~~~~~~~~~~....................................................................................................................
^^^^^^^^^^^^^~~~~~~~~~~~~~~~~~~~~~~~~~~~~~~~..............................................................................................................
^^^^^^^^^^^^^~~~~~~~~~~~~~~~~~~~~~~~~~~~~~~~~~............................................................................................................
^^^^^^^^^^^^^^^^~~~~~~~~~~~~~~~.......~~~~~~~~~...........................................................................................................
^^^^^^^^^^^^^^^^~~~~~~~~~~~~~~.........~~~~~~~~~~~~.......................................................................................................
^^^^^^^^^^^^^^^^^^^^^^~~~~~~~~~~......~~~~~~~~~~~~~~......................................................................................................
^^^^^^^^^^^^^^^^^^^^^^^^~~~~~~~~~~~~~~~~~~~~~~~~~~~~~~~...................................................................................................
^^^^^^^^^^^^^^^^^^^^^^^^^^~~~~~~~~~~~~~~~~~~~~~~~~~~~~~~~.................................................................................................
^^^^^^^^^^^^^^^^^^^^^^^^^^^~~~~~~~~~~~~~~~~~~~~~~~~~~~~~~~~~..............................................................................................
^^^^^^^^^^^^^^^^^^^^^^^^^^^^~~~~~~~~~~~~~~~~~~~~~~~~~~~~~~~~~~~...........................................................................................
^^^^^^^^^^^^^^^^^^^^^^^^^^^^^^^^^^^^^^^~~~~~~~~~~~~~~~~~~~~~~~~~~~~................................................................................@......
^^^^^^^^^^^^^^^^^^^^^^^^^^^^^^^^^^^^^^^^^^^^^~~~~~~~~~~~~~~~~~~~~~~~......................................................................................
^^^^^^^^^^^^^^^^^^^^^^^^^^^^^^^^^^^^^^^^^^^^^^^^^^^^^^^^^^^^^^^~~~~~......................................................................................